00002000000000001110000
00002200001100000110000
00011000000+00001100000
0001110000++00000000+00
0000200001000000000++00
000222000000000+++00000
00000220000000000++0000
00011100000002220000110
00010022000002200001110
00++0022200000001100000
000+0000000000011100000
00110000000000111000200
0011100000+000002200000
000000000++000000200110
0000++00000000001000010
0000++00000000000000220
00000000011000000200020
00200000011110000000000
00000200000++0000000000
00000220000++0000000000
00002220000000000000100