99999999999999999999999
99999999999999999999999
99999999999999999999999
99999999999999999999999
99999999999999999999999
99999999999999999999999
99999999999999999999999
99999999999999999999999
99999999999999999999999
99999999999999999999999
99999999999999999999999
99999999999999999999999
88AA888A8888888A8888A88
888A88888888888888AA888
888888A8888AA8888888888
77777777777777777777777
66666666666666666666666
66666666666666666666666
66666666666666666666666
66666666666666666666666
66666666666666666666666