33333335533333333333533
33333333533333333335533
33553333333333333333333
33353333333335533333333
33333333333333533333333
33355333333333333335533
33333353333333333333533
33333553333333333333333
33333333333333333533333
33355533333333335533333
33335553333333333333333
33333333333333333334333
43333333333333333334333
44334333333334343344334
44334334333434343344344
44344334433434343344344
44344344434434444444344
44344344444444444444444
44444444444444444444444
44444444444444444444444
44444444444444444444444