#######################
#######################
####@@#################
###@@@@@###############
#################@@@###
################@@@@###
#######################
########BBBBBBBBB######
####BBBC999999999D#####
BBBC99999999999999DBBBB
99999999999999999999999
99999999999999999999999
99999999999999999999999
99999999999999999999999
99999999999999999999999
99999999999999999999999
99999999999999999999999
99999999999999999999999
99999999999999999999999
99999999999999999999999
99999999999999999999999