$$$$$$$$$*$$$$$$$$$$$$$
$$$*$$$$$$$$$$$$$*$$$$$
$$$$$$$*$$$$$$$$$$$$$$$
$$$%%%$$$$$$$*$$$$$$$$$
$$%%%%%$$$$$$$$$$$$$$$$
$%%%%%%%$$$$$$$$$*$$$$$
$$%%%%%$$$$$$$$$$$$$$$$
$$$%%%$$$*$$$$$$$$$$$$$
$$$$$$$$$$$$$$$$$$*$$$$
$*$$$$$$$$$$$$$$$$$$$$$
$$$$$$$*$$$$$$$$$$$$*$$
$$$$*$$$$$$$$$*$$$$$$$$
$$$$$$$$*$$$$$$$$$$$$$$
$$$$$$$$$$$$$$$$*$$$$$$
$$$$$*$$$$$$$$$$$$$$$$$
$$$$$$$$$*$$$$$$$*$$$$$
$$$$$$*$$$$$$$*$$$$$$$$
$$$*$$$$$$$$$$$$$$*$$$$
$$$$$$$$$$$*$$$$$$$$$$$
$$$$$$$$$$$$$$$$$*$$$$$
$$$$$$$$$*$$$$$$$$$$$$$