$$$$$$$$$*$$$$$$$$$$$$$
$$$*$$$$$$$$$$$$$*$$$$$
$$$$$$$*$$$$$$$$$$$$$$$
$$$$$$$$$$$$$*$$$$$$$$$
$$$$$$$$$$$$$$$$$$$$$$$
$$$$$$$$$$$$$$$$$*$$$$$
$$$$$$$$$$$$$$$$$$$$$$$
$$$$$$$$$*$$$$$$$$$$$$$
$$$$$$$$$$$$$$$$$$*$$$$
$*$$$$$$$$$$$$$$$$$$$$$
$$$$$$$*$$$$$$$$$$$$*$$
$$$$*$$$$$$$$$*$$$$$$$$
$$$$$$$$*$$$$$$$$$$$$$$
$$$$$$$$$$$$$$$$*$$$$$$
$$$$$*$$$$$$$$$$$$$$$$$
$$$$$$$$$*$$$$$$$*$$$$$
$$$$$$*$$$$$$$*$$$$$$$$
$$$*$$$$$$$$$$$$$$*$$$$
$$$$$$$$$$$*$$$$$$$$$$$
$$$$$$$$$$$$$$$$$*$$$$$
$$$$$$$$$*$$$$$$$$$$$$$